{
	"Name": "\u0422\u0430\u0439\u043D\u0430\u044F \u0433\u0440\u043E\u0431\u043D\u0438\u0446\u0430",
	"NextChapter": "WaterTemple",
	"Map": [
		["H", "H", "H", "H", "H", "H", "H", "H", "H", "H", "H", "H", "H", "H", "H", "H", "H", "H", "H", "H", "H", "H", "H", "H", "H", "H", "H", "H", "H", "H", "H", "H", "H", "H", "H", "H", "H", "H", "H", "H", "H", "H", "H", "H", "H", "H", "H", "H", "H", "H", "H", "H", "H", "H", "H", "H", "H", "H", "H", "H"],
		["H", ".", ".", ".", ".", ".", ".", ".", ".", ".", ".", ".", ".", "H", ".", ".", ".", ".", ".", ".", ".", ".", ".", ".", ".", ".", ".", ".", ".", ".", "H", ".", ".", ".", ".", ".", ".", ".", ".", ".", ".", "H", ".", ".", ".", ".", ".", "H", ".", ".", ".", ".", ".", ".", ".", ".", ".", ".", ".", "H"],
		["H", ".", ".", "H", ".", "H", ".", ".", "H", ".", "H", ".", ".", ".", "H", "H", "H", "H", "H", "H", ".", "H", "H", "H", ".", ".", ".", ".", "H", ".", "H", ".", ".", ".", ".", ".", ".", ".", ".", ".", ".", "H", ".", ".", ".", ".", ".", "H", ".", ".", ".", ".", ".", "H", "H", "H", ".", ".", ".", "H"],
		["H", ".", ".", ".", "H", ".", ".", ".", ".", "H", ".", ".", ".", "H", ".", ".", ".", ".", ".", ".", ".", ".", ".", ".", "H", ".", "H", "H", "H", ".", "H", ".", ".", ".", ".", ".", "P", ".", ".", ".", ".", "H", ".", "H", "H", ".", ".", "H", ".", ".", ".", ".", "H", ".", ".", ".", ".", ".", ".", "H"],
		["H", "H", "H", ".", "H", "H", "H", "H", ".", "H", ".", ".", "H", ".", "H", ".", "H", "H", "H", "H", "H", "H", "H", "H", ".", ".", "H", ".", "H", ".", "H", ".", ".", ".", ".", "H", "X", "H", ".", ".", ".", "H", ".", ".", "H", "H", ".", "H", ".", ".", "H", "H", ".", ".", "H", "H", "H", ".", ".", "H"],
		["H", ".", ".", ".", "H", ".", ".", ".", ".", "H", "H", ".", ".", "H", ".", ".", ".", ".", ".", ".", ".", ".", ".", ".", "H", ".", "H", ".", "H", ".", "H", "H", ".", ".", ".", ".", "!", ".", ".", ".", "H", "H", "H", ".", "H", ".", ".", "H", ".", "H", "H", ".", ".", ".", ".", ".", "H", "H", ".", "H"],
		["H", "H", ".", "H", "H", ".", "H", "H", "H", "H", "?", "H", "H", ".", "H", "H", "H", "H", ".", "H", "H", "H", ".", ".", "H", ".", ".", ".", ".", ".", ".", "H", "H", ".", ".", ".", ".", ".", ".", "H", "H", "H", ".", ".", "H", ".", "H", "H", ".", "H", ".", ".", "H", "H", "H", "H", ".", "H", ".", "H"],
		["H", ".", ".", ".", "H", ".", ".", ".", ".", ".", ".", ".", ".", ".", "H", ".", ".", ".", "H", ".", ".", "$", "H", ".", ".", "H", "H", ".", "H", ".", ".", ".", "H", "H", "H", "H", "#", "H", "H", "H", ".", ".", ".", ".", "H", ".", ".", "H", ".", "H", ".", "H", "H", ".", ".", "H", ".", "H", ".", "H"],
		["H", ".", "H", "H", "H", "H", "H", "H", "H", "H", "H", "H", "H", ".", "H", ".", "H", ".", ".", ".", "H", "H", "H", ".", "H", ".", ".", "H", ".", ".", ".", "H", ".", "?", ".", "H", ".", ".", ".", ".", ".", ".", ".", "H", "H", "H", ".", "H", ".", "H", ".", "H", "!", ".", ".", "H", ".", "H", ".", "H"],
		["H", ".", "H", ".", ".", ".", ".", ".", ".", ".", ".", ".", "H", ".", "H", ".", "H", "H", "H", "P", "$", ".", ".", ".", ".", "H", "H", ".", ".", ".", "H", ".", ".", ".", ".", "H", "H", "H", "H", ".", ".", ".", ".", "?", "H", ".", ".", "H", ".", "H", ".", "H", "I", "H", ".", "H", ".", "H", ".", "H"],
		["H", ".", "H", ".", "H", "H", "H", "H", "H", "H", "H", ".", "H", ".", "H", ".", "H", ".", ".", ".", "H", "H", ".", ".", "H", ".", ".", "H", ".", "H", ".", ".", "H", ".", ".", ".", ".", ".", "@", "H", "H", "H", "H", "H", "H", ".", "H", "H", ".", "H", ".", ".", "H", "H", ".", "H", ".", "H", ".", "H"],
		["H", ".", "H", ".", "H", ".", ".", ".", ".", ".", "H", ".", "H", ".", ".", ".", "H", ".", ".", ".", ".", "H", ".", "H", ".", ".", "H", ".", ".", ".", "H", ".", ".", "H", "H", "H", ".", ".", ".", "H", "H", "H", ".", ".", ".", ".", ".", "H", ".", "H", "H", ".", ".", ".", ".", ".", "H", "H", ".", "H"],
		["H", ".", "H", ".", "H", ".", "H", "H", "H", ".", "H", ".", "H", "H", "H", "H", "H", ".", "H", ".", ".", ".", "H", ".", ".", ".", "H", ".", "H", ".", "H", ".", ".", ".", ".", ".", "H", ".", ".", ".", ".", ".", ".", ".", ".", "H", ".", "H", ".", ".", "H", "H", "H", "H", "H", "H", "H", ".", ".", "H"],
		["H", ".", "H", ".", "H", ".", "H", ".", ".", ".", "H", ".", ".", ".", ".", ".", ".", ".", "H", ".", ".", ".", "H", ".", ".", "H", ".", ".", ".", ".", ".", "H", "H", "H", "H", ".", ".", "H", "H", "H", "H", "H", "H", ".", ".", "H", ".", "H", ".", ".", ".", ".", ".", ".", ".", ".", ".", ".", ".", "H"],
		["H", ".", "H", ".", "H", ".", "H", ".", "H", ".", "H", ".", ".", ".", ".", ".", ".", ".", "H", ".", ".", "H", ".", ".", ".", "H", ".", ".", "H", ".", ".", ".", ".", ".", ".", "H", ".", ".", ".", ".", ".", ".", ".", "H", "H", "H", "H", "H", "H", "H", "H", "H", "H", "H", "H", "H", ".", ".", ".", "H"],
		["H", ".", "H", ".", "H", ".", "H", ".", "H", ".", "H", ".", ".", ".", "H", "H", "H", "H", "H", ".", ".", "H", ".", "H", "H", "H", "H", "H", ".", "H", "H", "H", "H", ".", ".", "H", "H", "H", "H", "H", "H", "H", ".", ".", "H", ".", ".", ".", ".", ".", ".", "H", ".", ".", ".", ".", ".", ".", ".", "H"],
		["H", ".", "H", ".", "H", ".", "H", ".", "H", "H", "H", "H", "H", ".", ".", ".", ".", ".", ".", ".", ".", "H", ".", ".", ".", "H", ".", ".", ".", ".", ".", ".", ".", "H", ".", ".", ".", ".", ".", ".", ".", "H", ".", ".", ".", ".", ".", ".", ".", ".", "H", ".", "H", ".", ".", ".", ".", ".", ".", "H"],
		["H", ".", ".", ".", ".", ".", "H", ".", ".", ".", ".", ".", ".", "H", "H", ".", ".", ".", "H", ".", ".", ".", "H", "H", ".", "H", ".", ".", "H", "S", "H", ".", "H", ".", "H", "H", "H", "H", "H", ".", ".", "H", "H", "H", "H", "H", ".", "H", "H", ".", ".", ".", "H", ".", ".", "?", "?", ".", ".", "H"],
		["H", "?", "H", "H", "#", "H", ".", ".", "H", "H", ".", "H", "H", ".", ".", "H", ".", ".", ".", ".", ".", ".", ".", "H", ".", ".", ".", ".", ".", ".", ".", ".", ".", ".", ".", ".", ".", ".", "H", ".", ".", ".", ".", ".", ".", "H", ".", ".", ".", ".", ".", "H", ".", ".", ".", "?", "?", ".", ".", "H"],
		["H", "H", "H", ".", ".", "H", "H", ".", ".", "H", ".", ".", ".", ".", ".", ".", "H", ".", ".", ".", "H", ".", ".", "H", "H", "H", "H", "H", "H", "#", "H", "H", ".", "H", "H", "H", ".", ".", "H", ".", ".", "H", "H", "H", ".", "H", "H", "H", "H", ".", ".", "H", ".", ".", ".", ".", ".", ".", ".", "H"],
		["H", ".", ".", ".", ".", ".", "H", "H", "H", ".", ".", "H", ".", ".", ".", ".", "H", ".", ".", ".", ".", ".", ".", "H", ".", ".", ".", ".", ".", ".", ".", "H", ".", ".", ".", "H", ".", ".", ".", "H", "H", ".", ".", "H", ".", ".", ".", ".", "H", ".", ".", "H", "H", "H", "H", "H", "H", "P", "H", "H"],
		["H", ".", "H", ".", ".", ".", ".", "H", "H", "H", "H", "K", ".", ".", ".", ".", "H", ".", "H", ".", ".", "H", "H", ".", ".", ".", ".", ".", ".", ".", ".", "H", "H", "H", ".", "H", ".", "H", ".", ".", ".", ".", "H", ".", "H", "H", "H", ".", ".", ".", ".", ".", ".", ".", ".", ".", "H", "P", "H", "H"],
		["H", ".", "H", ".", ".", ".", ".", ".", ".", ".", "H", "H", ".", ".", "?", ".", "H", ".", ".", ".", ".", ".", ".", "H", ".", "H", "H", ".", ".", ".", ".", ".", ".", "H", "?", "H", ".", ".", ".", ".", ".", "H", "H", ".", ".", ".", "H", ".", ".", ".", ".", ".", ".", ".", ".", ".", "H", "P", "P", "H"],
		["H", ".", "H", ".", "H", "H", "H", ".", ".", ".", ".", "H", ".", ".", ".", ".", "H", ".", ".", ".", "H", ".", "H", ".", "H", ".", ".", "H", ".", ".", ".", ".", ".", "H", "P", "H", "H", "H", "H", "H", ".", "H", ".", ".", "H", ".", ".", "H", "H", "H", "H", ".", ".", ".", ".", ".", "H", "H", "P", "H"],
		["H", ".", "H", ".", "H", ".", ".", ".", ".", ".", "H", "$", ".", ".", "H", "H", "H", ".", ".", ".", ".", ".", "H", ".", ".", ".", ".", ".", ".", ".", ".", ".", ".", "H", ".", ".", ".", ".", ".", "H", ".", ".", ".", ".", "H", ".", ".", ".", ".", ".", "H", ".", ".", ".", ".", ".", "H", "P", "P", "H"],
		["H", "H", "H", ".", "H", "H", "H", "H", ".", ".", "H", "H", ".", ".", "H", "@", "H", ".", ".", ".", ".", ".", ".", "H", ".", ".", "H", ".", ".", ".", ".", ".", ".", "H", ".", ".", "H", ".", "H", "H", "H", "H", "H", "H", "H", ".", "H", ".", ".", ".", ".", ".", ".", ".", ".", ".", "H", "P", "H", "H"],
		["H", ".", ".", ".", "H", ".", ".", ".", ".", ".", ".", "H", "H", "H", "H", ".", "H", "H", "H", "H", "H", "H", ".", ".", "H", ".", ".", "H", ".", ".", ".", "H", "H", "H", ".", "H", "H", ".", ".", ".", ".", ".", ".", ".", ".", "H", "H", "H", "H", ".", ".", ".", ".", ".", ".", ".", ".", ".", ".", "H"],
		["H", ".", "H", "H", "H", ".", ".", ".", "?", ".", ".", "H", ".", ".", ".", ".", ".", "H", ".", "$", "H", ".", ".", ".", ".", "H", ".", ".", "H", "H", "H", "H", ".", ".", ".", ".", "H", "H", ".", ".", "H", ".", ".", ".", ".", ".", "H", ".", ".", "H", "H", "H", ".", "H", ".", ".", "H", ".", ".", "H"],
		["H", ".", ".", ".", "H", ".", ".", "H", "H", "H", ".", ".", ".", ".", "H", ".", ".", "H", ".", "H", ".", ".", ".", "H", ".", ".", "H", ".", ".", "H", ".", ".", ".", "H", "H", "H", "H", "H", "H", "H", "H", "H", "H", ".", "H", ".", ".", "H", ".", ".", ".", ".", ".", "H", ".", ".", "H", "H", ".", "H"],
		["H", ".", "H", ".", "H", ".", ".", ".", ".", "H", ".", ".", "H", ".", ".", ".", ".", "H", ".", ".", "H", "H", ".", ".", "H", ".", "H", ".", ".", "H", ".", ".", ".", "H", ".", ".", ".", "H", "H", ".", ".", ".", ".", "H", ".", "H", ".", ".", "H", "H", "H", "H", "H", "H", "H", ".", "H", ".", ".", "H"],
		["H", ".", "H", ".", "H", ".", ".", ".", ".", "H", "H", "H", "H", ".", ".", ".", ".", "H", "H", ".", "H", ".", ".", "H", ".", ".", "H", ".", "H", "H", ".", ".", ".", "H", ".", "H", ".", "H", ".", ".", ".", "H", ".", "H", ".", ".", "H", ".", ".", ".", ".", ".", ".", ".", ".", ".", ".", ".", "H", "H"],
		["H", "H", "H", ".", "H", "H", "H", ".", ".", "H", ".", ".", ".", ".", ".", ".", ".", ".", ".", ".", "H", ".", "H", "H", "H", "H", "H", ".", ".", "H", ".", ".", ".", "H", ".", "H", ".", "H", ".", "H", "H", "H", ".", "H", "H", ".", ".", "H", "H", "H", "H", ".", ".", "H", "H", ".", "H", ".", ".", "H"],
		["H", ".", ".", ".", "H", ".", ".", ".", ".", "H", "H", ".", ".", "H", ".", ".", "H", ".", ".", ".", "H", ".", "H", ".", ".", ".", "H", ".", "H", "H", ".", ".", ".", ".", ".", "H", ".", ".", ".", ".", "H", ".", ".", ".", "H", "H", ".", ".", ".", ".", "H", ".", ".", "H", ".", ".", "H", "H", ".", "H"],
		["H", ".", "K", ".", "H", ".", ".", ".", ".", ".", ".", ".", "?", ".", ".", ".", ".", ".", "@", ".", "H", ".", "H", ".", "H", ".", "H", ".", ".", "H", ".", ".", ".", ".", ".", "H", ".", "?", "?", ".", "H", ".", "K", ".", "H", ".", ".", ".", "H", ".", ".", ".", ".", "H", ".", ".", "H", ".", ".", "H"],
		["H", ".", ".", ".", "P", ".", ".", ".", ".", ".", ".", ".", ".", ".", ".", ".", ".", ".", ".", ".", "P", ".", ".", ".", "P", ".", ".", ".", ".", "P", ".", ".", ".", ".", ".", ".", ".", ".", ".", ".", ".", ".", ".", ".", ".", ".", ".", ".", ".", ".", ".", ".", ".", ".", ".", ".", ".", ".", ".", "H"],
		["H", "H", "H", "H", "H", "H", "H", "H", "H", "H", "H", "H", "H", "H", "H", "H", "H", "H", "H", "H", "H", "H", "H", "H", "H", "H", "H", "H", "H", "H", "H", "H", "H", "H", "H", "H", "H", "H", "H", "H", "H", "H", "H", "H", "H", "H", "H", "H", "H", "H", "H", "H", "H", "H", "H", "H", "H", "H", "H", "H"]
	],
	"BackCover": "/Resources/Media/Images/Locations/SecretTemple/Way.svg",
	"BattleBack": "/Resources/Media/Images/Battle/Background/SecretTemple.svg",
	"MusicPeace": "/Resources/Media/OST/Music/SecretTemple/Peace.mp3",
	"MusicFight": "/Resources/Media/OST/Music/SecretTemple/Fight.mp3",
	"Start": {
		"X": 18,
		"Y": 34
	},
	"Danger": {
		"IsZero": false,
		"X": 9,
		"Y": 27
	},
	"IsTimeChamber": false,
	"StageFoes": [0, 1, 2, 3],
	"Bosses": {
		"36:5": 12,
		"52:8": 15
	},
	"Messages": {
		"19:27": "\u041D\u0430\u0439\u0434\u0435\u043D \u0027\u0427\u0435\u0440\u043D\u044B\u0439 \u043A\u043E\u0436\u0430\u043A\u0027!",
		"11:24": "\u041D\u0430\u0439\u0434\u0435\u043D\u044B \u0027\u0411\u0438\u043D\u0442\u044B\u0027!",
		"20:9": "\u041D\u0430\u0439\u0434\u0435\u043D \u0027\u041A\u043E\u0441\u0442\u044F\u043D\u043E\u0439 \u043A\u0430\u0441\u0442\u0435\u0442\u0027!",
		"21:7": "\u041D\u0430\u0439\u0434\u0435\u043D\u044B \u0027\u0428\u0442\u0430\u043D\u044B \u0441\u0442\u0435\u0440\u0432\u044F\u0442\u043D\u0438\u043A\u0430\u0027!",
		"52:9": "\u041D\u0430\u0439\u0434\u0435\u043D\u044B \u0027\u0424\u0443\u0442\u0431\u043E\u043B\u043A\u0430 \u0441\u0435\u0440\u044C\u0435\u0437\u043D\u043E\u0433\u043E\u0027!",
		"18:33": "\u041F\u0443\u0442\u044C \u0443\u043A\u0430\u0436\u0443\u0442 \u0432\u0435\u043B\u0438\u043A\u0438\u0435 \u0441\u0442\u0440\u0435\u043B\u044B...",
		"15:25": "\u041A\u043B\u044E\u0447, \u0447\u0442\u043E \u043E\u0442\u043A\u0440\u043E\u0435\u0442 \u043B\u044E\u0431\u044B\u0435 \u0434\u0432\u0435\u0440\u0438.",
		"38:10": "\u041A\u0442\u043E \u0448\u0435\u043F\u0447\u0435\u0442 \u0442\u0435\u0431\u0435 \u0432\u0441\u0435 \u043E\u0431\u043E \u0432\u0441\u0435\u043C?"
	},
	"Gates": {
		"2:33": {
			"X": 4,
			"Y": 18
		},
		"11:21": {
			"X": 29,
			"Y": 19
		},
		"42:33": {
			"X": 36,
			"Y": 7
		}
	},
	"Warps": null,
	"Equipment": {
		"19:27": {
			"Kind": 1,
			"Set": 1
		},
		"11:24": {
			"Kind": 3,
			"Set": 1
		},
		"20:9": {
			"Kind": 0,
			"Set": 1
		},
		"21:7": {
			"Kind": 2,
			"Set": 1
		},
		"52:9": {
			"Kind": 1,
			"Set": 4
		}
	},
	"TileCodes": {
		"?": "/Resources/Media/Images/Locations/Total/Surprise.svg",
		"H": "/Resources/Media/Images/Locations/SecretTemple/Wall.svg",
		"P": "/Resources/Media/Images/Locations/SecretTemple/Wall.svg",
		"X": "/Resources/Media/Images/Locations/SecretTemple/Artifact.svg",
		".": "/Resources/Media/Images/Locations/Total/Transparent.svg",
		":": "/Resources/Media/Images/Locations/Total/Spikes.svg",
		"_": "/Resources/Media/Images/Locations/Total/Button.svg",
		"!": "/Resources/Media/Images/Locations/Total/Transparent.svg",
		"I": "/Resources/Media/Images/Locations/Total/Transparent.svg",
		"S": "/Resources/Media/Images/Locations/Total/SafeArea.svg",
		"$": "/Resources/Media/Images/Locations/Total/Chest/Closed.svg",
		"E": "/Resources/Media/Images/Locations/Total/Chest/Opened.svg",
		"K": "/Resources/Media/Images/Locations/Total/Key.svg",
		"#": "/Resources/Media/Images/Locations/Total/Lock.svg",
		"@": "/Resources/Media/Images/Locations/Total/Table.svg"
	}
}
