{
	"Name": "\u0412\u0435\u043B\u0438\u043A\u0438\u0439 \u043F\u043E\u0431\u0435\u0433",
	"NextChapter": "",
	"Map": [
		["H", "H", "H", "H", "H", "H", "H", "H", "H", "H", "H", "H", "H", "H", "H", "H", "H", "H", "H", "H", "H", "H", "H", "H", "H", "H", "H", "H", "H", "H", "H", "H", "H", "H", "H", "H", "H", "H", "H", "H", "H", "H", "H", "H", "H", "H", "H", "H", "H", "H", "H", "H", "H", "H", "H", "H", "H", "H", "H", "H"],
		["H", ".", ".", ".", ".", ".", ".", ".", ".", ".", ".", ".", ".", ".", ".", ".", ".", ".", ".", ".", ".", ".", ".", ".", "H", ".", ".", ".", ".", "H", ".", "H", ".", ".", ".", "H", ".", ".", ".", "H", ".", ".", ".", ".", "H", "H", "H", "H", ".", ".", ".", ".", ".", ".", ".", ".", ".", ".", ".", "H"],
		["H", ".", "H", "H", ".", "H", ".", ".", ".", ".", ".", ".", "H", ".", ".", ".", "H", "H", "H", "H", "H", "H", ".", ".", "H", ".", ".", ".", ".", ".", ".", ".", ".", "H", ".", ".", ".", "H", ".", ".", ".", "H", ".", ".", ".", ".", ".", ".", ".", ".", "H", "H", "H", "H", "H", ".", ".", ".", ".", "H"],
		["H", ".", "H", ".", ".", "H", "H", ".", "H", "H", "H", ".", "H", "H", "H", ".", ".", "H", ".", ".", ".", ".", ".", ".", "H", ".", "H", ".", "H", "H", "H", "H", "H", "H", "H", "H", "H", "H", "H", "H", "H", "H", "H", "H", "H", "H", "H", "H", "H", "H", "H", "H", "H", "H", "H", ".", ".", "H", ".", "H"],
		["H", ".", ".", ".", "H", ".", ".", ".", ".", ".", "H", ".", ".", ".", ".", ".", ".", "H", ".", ".", ".", "H", "H", "H", "H", ".", "H", ".", "H", ".", ".", ".", "H", ".", ".", ".", ".", ".", ".", "H", ".", ".", ".", ".", "H", ".", ".", ".", "H", ".", ".", ".", "H", ".", ".", ".", ".", "H", ".", "H"],
		["H", ".", ".", "H", "H", "H", ".", ".", ".", ".", ".", ".", ".", ".", ".", ".", ".", ".", ".", ".", ".", "H", ".", ".", ".", ".", "H", ".", "H", ".", "H", ".", "H", ".", ".", "H", "H", ".", "H", "H", "H", ".", "H", ".", "H", ".", "H", ".", "H", ".", "H", ".", "H", ".", ".", ".", ".", "H", ".", "H"],
		["H", ".", ".", ".", ".", ".", "H", ".", ".", "H", "H", "H", "H", ".", "H", ".", ".", ".", "H", ".", ".", "H", "H", "P", "H", "H", "H", "H", "H", ".", "H", ".", "H", "H", ".", ".", "H", ".", ".", "H", ".", ".", "H", ".", "H", ".", "H", ".", "H", ".", "H", ".", "H", ".", ".", ".", ".", "H", ".", "H"],
		["H", ".", "H", ".", "H", ".", "H", ".", ".", ".", ".", ".", ".", ".", "H", "H", "H", ".", "H", "H", ".", ".", ".", "P", "H", ".", ".", ".", "H", ".", "H", ".", ".", ".", "H", ".", "H", ".", "H", "H", "H", ".", "H", ".", "H", ".", "H", ".", "H", ".", "H", ".", "H", ".", "H", "H", "H", "H", ".", "H"],
		["H", "H", "H", ".", "H", "H", "H", "H", "H", "H", "H", "H", "H", ".", "H", ".", ".", ".", ".", "H", "H", ".", ".", "H", ".", ".", "H", ".", "H", ".", "H", "H", "H", ".", ".", ".", "H", ".", ".", "H", ".", ".", "H", ".", "H", ".", "H", ".", "H", ".", "H", ".", "H", ".", "H", ".", ".", ".", ".", "H"],
		["H", ".", ".", ".", ".", ".", ".", ".", ".", ".", ".", ".", ".", "H", ".", ".", "H", ".", "H", ".", "H", "H", ".", "H", ".", ".", "H", ".", "H", ".", ".", ".", "H", "H", ".", ".", "H", ".", ".", ".", ".", ".", "H", ".", ".", ".", "H", ".", ".", ".", "H", ".", ".", ".", "H", ".", "H", "H", "H", "H"],
		["H", "H", "H", "H", "H", "H", "H", "H", "H", "H", "H", "H", ".", ".", "H", ".", ".", "H", ".", ".", ".", "H", ".", "H", "H", ".", "H", ".", ".", "H", ".", "H", ".", "H", "H", "H", "H", "H", "H", "H", "H", "H", "H", "H", "H", "H", "H", "H", "H", "H", "H", "H", "H", "H", "H", ".", ".", ".", ".", "H"],
		["H", ".", ".", ".", ".", ".", ".", ".", ".", ".", ".", ".", ".", "H", "H", ".", ".", ".", ".", ".", "H", "H", ".", "H", ".", ".", "H", ".", ".", "H", ".", "H", ".", ".", ".", "H", ".", ".", ".", ".", ".", ".", ".", ".", ".", ".", "H", "H", ".", ".", ".", ".", ".", ".", "H", "H", "H", "H", ".", "H"],
		["H", ".", "H", "H", "H", "H", "H", "H", "H", "H", "H", "H", "H", "H", ".", ".", "H", ".", ".", "H", "H", ".", ".", "H", ".", "H", "H", ".", ".", "H", ".", ".", ".", "H", ".", "H", ".", "H", "H", "H", "H", "H", ".", ".", "H", "H", ".", ".", ".", ".", ".", "H", ".", ".", "H", ".", "H", ".", ".", "H"],
		["H", ".", ".", ".", ".", ".", ".", ".", ".", ".", ".", ".", "H", ".", ".", ".", ".", ".", "H", "H", ".", ".", ".", "H", ".", ".", "H", ".", ".", "H", ".", "H", ".", "H", ".", ".", ".", "H", ".", ".", ".", ".", ".", ".", ".", ".", ".", ".", "H", "H", ".", "H", ".", ".", "H", ".", "H", ".", ".", "H"],
		["H", "H", "H", "H", "H", "H", "H", "H", "H", "H", "H", ".", "H", ".", "H", ".", ".", ".", "H", ".", ".", ".", ".", "H", "H", ".", "H", ".", ".", "H", ".", "H", "H", "H", "H", "H", "H", "H", "H", "H", "H", "H", "H", ".", "H", "H", "H", "H", "H", ".", ".", "H", ".", ".", "H", ".", ".", ".", ".", "H"],
		["H", ".", ".", ".", "H", ".", ".", ".", "H", ".", ".", ".", "H", ".", ".", ".", "H", ".", "H", "H", ".", ".", ".", "H", ".", ".", "H", ".", ".", "H", ".", ".", "H", "H", "H", "H", ".", ".", ".", ".", ".", ".", "H", ".", ".", ".", ".", ".", "H", ".", ".", "H", ".", ".", "H", "H", "H", "H", "H", "H"],
		["H", ".", "H", ".", "H", ".", "H", ".", "H", ".", "H", ".", "H", "H", ".", ".", ".", ".", ".", "H", "H", ".", ".", "H", ".", "H", "H", ".", ".", "H", ".", ".", ".", ".", ".", ".", ".", "H", ".", ".", ".", ".", "H", "H", "H", "H", "H", "H", "H", ".", ".", "H", ".", ".", ".", ".", ".", ".", ".", "H"],
		["H", ".", "H", ".", ".", ".", "H", ".", ".", ".", "H", ".", ".", "H", "H", ".", ".", "H", ".", ".", "H", "H", ".", "P", ".", ".", "H", ".", ".", "H", "H", "H", "H", "H", "H", "H", "H", "H", ".", ".", ".", ".", ".", ".", "H", ".", "H", ".", ".", ".", ".", "H", ".", ".", ".", ".", "H", ".", ".", "H"],
		["H", ".", "H", "H", "H", "H", "H", "H", "H", "H", "H", "H", "H", ".", "H", "H", ".", ".", ".", ".", ".", "H", "H", "H", "H", ".", "H", ".", ".", ".", ".", ".", ".", ".", ".", ".", ".", ".", "H", "H", "H", "H", "H", ".", "H", ".", "H", "H", "H", "H", "H", "H", "H", "H", "H", ".", "H", ".", ".", "H"],
		["H", ".", ".", ".", ".", ".", ".", ".", ".", ".", ".", ".", ".", ".", ".", "H", "P", ".", ".", ".", ".", ".", ".", ".", ".", ".", "H", ".", ".", ".", ".", ".", ".", ".", ".", ".", ".", ".", ".", ".", ".", ".", ".", ".", "H", ".", ".", ".", ".", ".", ".", "H", ".", ".", "H", ".", "H", ".", ".", "H"],
		["H", "H", "H", "H", "H", "H", "H", ".", "H", "H", "H", "H", "H", "H", "H", ".", "P", "H", "H", "H", "H", "H", "H", "H", "H", "H", "H", "H", "H", "H", "H", "H", "H", "H", "H", "H", "H", "H", "H", "H", "H", "H", "H", "H", "H", ".", ".", "H", ".", ".", "H", ".", ".", ".", "H", "H", "H", ".", ".", "H"],
		["H", ".", ".", ".", ".", ".", ".", ".", ".", ".", ".", ".", ".", ".", ".", ".", ".", ".", ".", ".", ".", ".", ".", ".", ".", ".", ".", ".", ".", ".", ".", ".", ".", ".", ".", ".", ".", ".", ".", ".", ".", ".", ".", ".", ".", ".", ".", ".", "H", ".", ".", ".", "H", ".", ".", ".", "H", ".", ".", "H"],
		["H", "H", "H", "H", "H", "H", "H", "H", "H", "H", "H", "H", "H", "H", "H", "H", "H", "H", "H", "H", "H", "H", "H", "H", "H", "H", "H", "H", "H", "H", "H", "H", "H", "H", "H", "H", "H", "H", "H", "H", "H", "H", "H", "H", "H", "H", "H", "H", "H", "H", "H", "H", "H", "H", "H", ".", "H", "H", "H", "H"],
		["H", ".", ".", ".", ".", ".", ".", ".", ".", ".", ".", ".", ".", ".", ".", ".", ".", ".", ".", ".", ".", ".", ".", ".", ".", ".", ".", ".", ".", ".", ".", ".", ".", ".", ".", ".", ".", ".", ".", ".", ".", ".", ".", ".", ".", ".", ".", ".", ".", ".", ".", ".", ".", ".", ".", ".", ".", ".", ".", "H"],
		["H", ".", "H", "H", "H", "H", "H", "H", "H", "H", "H", "H", "H", "H", "H", "H", "H", "H", "H", "H", "H", "H", "H", "H", "H", "H", "H", "H", "H", "H", "H", "H", "H", "H", "H", "H", "H", "H", "H", "H", "H", "H", "H", "H", "H", "H", "H", "H", "H", "H", "H", "H", "H", "H", "H", "H", "H", "H", "H", "H"],
		["H", ".", ".", ".", ".", ".", ".", ".", ".", "H", ".", "H", ".", "H", ".", "H", ".", ".", ".", ".", ".", ".", ".", ".", ".", ".", ".", ".", ".", ".", ".", ".", ".", ".", "H", ".", "H", ".", ".", ".", ".", ".", ".", ".", "H", ".", ".", ".", "H", ".", ".", ".", "H", ".", ".", ".", ".", ".", ".", "H"],
		["H", ".", "H", "H", ".", ".", "H", ".", ".", "H", ".", "H", ".", ".", ".", "H", ".", "H", "H", "H", ".", ".", "H", ".", "H", ".", ".", ".", ".", ".", "H", "H", "H", ".", "H", ".", "H", ".", ".", "H", "H", "H", ".", ".", ".", ".", ".", ".", ".", ".", ".", ".", ".", ".", ".", ".", ".", ".", ".", "H"],
		["H", ".", ".", "H", "H", ".", "H", ".", ".", ".", ".", "H", ".", "H", ".", "H", ".", ".", "H", ".", ".", ".", "H", "H", "H", ".", "H", "H", "H", ".", "H", ".", "H", ".", "H", "H", "H", ".", ".", ".", "H", ".", ".", "H", "H", "H", "H", "H", "H", "H", "H", "H", "H", "H", "H", "H", "H", ".", ".", "H"],
		["H", ".", "H", "H", ".", ".", "H", ".", ".", "H", ".", "H", ".", "H", ".", "H", ".", ".", "H", ".", "H", ".", "H", ".", "H", ".", "H", "H", ".", ".", "H", "H", "H", ".", ".", ".", ".", ".", ".", ".", "H", ".", "H", ".", ".", ".", ".", ".", ".", "H", "H", "H", "H", ".", ".", ".", ".", ".", ".", "H"],
		["H", ".", ".", "H", "H", ".", "H", ".", ".", "H", "H", "H", ".", "H", ".", "H", ".", ".", ".", ".", "H", ".", ".", ".", ".", ".", "H", "H", "H", ".", ".", ".", ".", ".", ".", "H", "H", "H", "H", "H", ".", "P", ".", ".", "H", "H", "H", "H", ".", ".", ".", ".", ".", ".", "H", "H", "H", "H", "H", "H"],
		["H", ".", "H", "H", ".", ".", "H", ".", "H", "H", ".", ".", ".", "H", ".", "H", ".", "H", ".", ".", "H", ".", ".", "H", "H", ".", ".", ".", "H", "H", "H", "H", "H", "H", "H", "H", ".", ".", ".", ".", "P", ".", ".", "H", "H", "H", "H", "H", "H", "H", "H", "H", "H", "H", "H", "H", "H", "H", "H", "H"],
		["H", ".", ".", "H", "H", ".", "H", ".", "H", ".", ".", "H", ".", "H", ".", "H", ".", "H", "H", ".", ".", ".", ".", "H", "H", ".", ".", ".", "H", ".", ".", ".", ".", ".", ".", ".", "H", ".", "H", ".", "H", "H", ".", ".", "H", ".", ".", ".", "H", ".", ".", ".", ".", "H", "H", ".", ".", ".", ".", "H"],
		["H", ".", ".", ".", ".", ".", "H", ".", ".", ".", "H", "H", ".", "H", ".", "H", ".", ".", "H", ".", ".", "H", ".", ".", ".", ".", "H", "H", "H", ".", "H", "H", "H", ".", ".", ".", "H", ".", "H", ".", "H", ".", "H", ".", ".", ".", "H", ".", ".", ".", "H", "H", ".", ".", ".", ".", "H", ".", ".", "H"],
		["H", ".", "H", "H", "H", "H", "H", ".", "H", ".", ".", "H", ".", "H", ".", ".", ".", ".", ".", ".", "H", "H", "H", ".", ".", ".", "H", "H", ".", ".", ".", "H", "H", ".", ".", ".", "H", ".", "H", ".", ".", ".", ".", "H", "H", "H", "H", "H", "H", "H", "H", "H", "H", "H", "H", "H", "H", ".", ".", "H"],
		["H", ".", ".", ".", ".", ".", ".", ".", "H", ".", ".", "H", ".", "H", ".", "H", ".", ".", ".", ".", ".", ".", ".", ".", ".", ".", "H", "H", ".", ".", ".", "H", "H", ".", ".", ".", ".", ".", "H", ".", "H", ".", ".", ".", ".", ".", ".", ".", ".", ".", ".", ".", ".", ".", ".", ".", ".", ".", ".", "H"],
		["H", "H", "H", "H", "H", "H", "H", "H", "H", "H", "H", "H", "H", "H", "H", "H", "H", "H", "H", "H", "H", "H", "H", "H", "H", "H", "H", "H", "H", "X", "H", "H", "H", "H", "H", "H", "H", "H", "H", "H", "H", "H", "H", "H", "H", "H", "H", "H", "H", "H", "H", "H", "H", "H", "H", "H", "H", "H", "H", "H"]
	],
	"BackCover": "/Resources/Media/Images/Locations/TheGreatEscape/Way.svg",
	"BattleBack": "",
	"MusicPeace": "/Resources/Media/OST/Music/WaterTemple/Peace.mp3",
	"MusicFight": "",
	"Start": {
		"X": 31,
		"Y": 1
	},
	"Danger": {
		"IsZero": false,
		"X": 2,
		"Y": 0
	},
	"IsTimeChamber": true,
	"StageFoes": [],
	"Bosses": {},
	"Messages": null,
	"Gates": null,
	"Warps": null,
	"Equipment": null,
	"TileCodes": {
		".": "/Resources/Media/Images/Locations/Total/Transparent.svg",
		"H": "/Resources/Media/Images/Locations/WaterTemple/Wall.svg"
	}
}