{
	"Name": "\u0425\u0440\u0430\u043C \u0432\u043E\u0434\u044B",
	"NextChapter": "FireTemple",
	"Map": [
		["H", "H", "H", "H", "H", "H", "H", "H", "H", "H", "H", "H", "H", "H", "H", "H", "H", "H", "H", "H", "H", "H", "H", "H", "H", "H", "H", "H", "H", "H", "H", "H", "H", "H", "H", "H", "H", "H", "H", "H", "H", "H", "H", "H", "H", "H", "H", "H", "H", "H", "H", "H", "H", "H", "H", "H", "H", "H", "H", "H"],
		["H", ".", ".", ".", "H", ".", ".", ".", ".", ".", ".", "H", ".", ".", ".", ".", "H", ".", ".", "H", ".", "H", ".", ".", ".", ".", ".", ".", ".", ".", ".", ".", ".", ".", ".", ".", ".", ".", ".", ".", ".", ".", ".", ".", ".", "H", ".", ".", ".", ".", ".", ".", ".", "H", ".", ".", ".", ".", ".", "H"],
		["H", ".", "H", ".", "H", ".", ".", ".", ".", ".", ".", "H", ".", "H", ".", ".", ".", "H", ".", ".", ".", "H", ".", ".", ".", ".", "H", ".", ".", ".", ".", ".", ".", ".", ".", "H", "H", "H", "H", ".", "H", "H", "H", "H", "H", ".", ".", "H", "H", "H", ".", ".", ".", "H", "H", "H", ".", ".", ".", "H"],
		["H", ".", "H", ".", ".", ".", ".", ".", ".", ".", ".", "H", ".", ".", ".", "H", ".", ".", ".", "H", ".", "H", ".", ".", ".", "H", "H", "H", ".", ".", "H", ".", ".", ".", "H", ".", ".", ".", ".", ".", ".", ".", ".", ".", ".", "H", ".", ".", ".", "H", ".", ".", ".", "H", "?", "H", ".", ".", ".", "H"],
		["H", ".", "H", "H", "H", "H", ".", "H", "H", "H", ".", "H", ".", "H", "H", "H", "H", "H", "H", "H", ".", "H", ".", ".", ".", ".", "H", ".", ".", "H", "H", ".", ".", ".", ".", "H", "H", "H", "H", "H", "H", "H", "H", "H", ".", "H", ".", ".", "H", ".", ".", "H", ".", "H", "#", "H", ".", "H", ".", "H"],
		["H", ".", ".", "?", ".", "H", ".", ".", ".", "H", ".", "H", ".", ".", ".", ".", ".", ".", ".", "H", ".", "H", ".", ".", ".", ".", ".", ".", ".", ".", ".", ".", ".", "H", "H", ".", ".", ".", ".", ".", ".", ".", ".", ".", ".", ".", "H", ".", ".", ".", ".", "H", ".", ".", "_", "H", "$", "H", ".", "H"],
		["H", ".", ".", "H", "H", ".", ".", "H", "H", "H", ".", "H", "H", "H", "H", "H", "H", "H", ".", "H", ".", "H", ".", ".", ".", "?", ".", ".", ".", "H", "H", ".", "H", ".", ".", "H", "H", "H", ".", "H", "H", "H", "H", "H", ".", "H", ".", ".", "H", "H", "H", "H", ".", "H", ".", "H", "H", "H", ".", "H"],
		["H", ".", ".", ".", "H", ".", ".", ".", ".", ".", ".", ":", ":", ".", ".", ".", ".", ".", ".", "H", ".", ".", ".", ".", ".", ".", ".", ".", ".", ".", ".", ".", "H", ".", ".", ".", "H", ".", ".", ".", ".", ".", "H", ".", "H", ".", ".", ".", ".", "H", "H", ".", ".", "H", ".", "H", ".", "H", ".", "H"],
		["H", ".", "_", ":", ".", "H", ".", ":", "H", ".", "H", ".", ":", ":", ".", ".", ".", ".", "H", "H", "H", "H", ".", ".", "H", ".", ".", "H", "H", "H", "H", "H", ".", ".", "H", ".", "P", ".", "H", ".", "H", ".", ".", ".", ".", "H", "H", ".", ".", ".", ".", ".", ".", "H", ".", "H", ".", "H", ".", "H"],
		["H", ".", ".", "H", "H", ":", ".", "H", "$", "H", ".", ".", ":", ":", "H", "H", "H", "H", "H", ".", ".", "H", ".", ".", "H", ".", ".", "H", ".", ".", ".", ".", ".", "?", "H", "H", "H", ".", "H", "H", "H", "H", ".", ".", ".", "H", ".", ".", "H", ".", ".", "H", ".", "H", ".", "H", ".", ".", ".", "H"],
		["H", ".", "H", ".", ".", ".", ".", "H", ".", "H", "H", "H", "H", "H", "H", ".", "H", ".", ".", ".", ".", ".", "H", "H", "$", "H", "H", ".", ".", ".", ".", ".", ":", ".", ":", ":", ".", "H", ".", "H", ".", ".", ".", ".", ".", "H", ".", ".", "H", "H", "H", "H", ".", "H", ".", "H", ".", "H", ".", "H"],
		["H", ".", ":", "H", "H", ".", "H", ".", ".", ".", ".", "H", ".", ".", ".", ".", "H", ".", ".", ".", "H", ".", ".", ":", ".", ":", ".", ".", "H", ".", ".", ".", ":", ":", ".", ":", ".", "H", ".", ".", ".", "H", ".", ".", ".", "H", "H", ".", "H", ".", ".", "H", ".", "H", ".", "H", ".", "H", ".", "H"],
		["H", ":", ":", ".", ".", ".", ".", "H", ".", "H", ".", ".", ".", "H", ".", ".", "H", ".", "?", ".", ".", ".", ":", ".", "H", ".", ":", ".", ".", ".", ".", ".", ".", ".", ".", ".", ".", "H", ".", "H", "H", "H", "H", "H", "H", ".", ".", ".", "H", ".", ".", "H", ".", "H", ".", "H", ".", "H", ".", "H"],
		["H", ".", ".", ".", ".", ".", ".", "H", "H", "H", "H", "H", ".", "H", ".", ".", "H", ".", ".", ".", ".", "H", ".", ".", "H", ".", ".", "H", ".", ".", ".", "?", ".", ".", ".", ".", ".", "H", ".", ".", ".", ".", ".", "H", ".", ".", ".", ".", ".", ".", ".", ".", ".", "H", ".", "H", ".", "H", ".", "H"],
		["H", "?", "?", "H", "H", "H", ".", ".", ".", "H", ".", ".", ".", "H", ".", ".", "H", ".", ".", ".", ".", ".", ".", ".", "H", ".", ".", ".", "H", ".", ".", ".", ".", ":", ":", ".", ".", "?", "H", "H", ".", ".", ".", "H", ".", "H", "H", "H", "H", "H", "H", "H", "H", "H", ".", "H", ".", "H", ".", "H"],
		["H", "P", "H", ".", ".", ".", "H", ".", ".", "H", ".", ".", "H", "H", ".", ".", ".", "H", "H", ".", ".", ".", "H", ".", "H", ".", "H", ".", ".", "H", ".", ".", ":", ".", ".", ":", ".", "H", ".", "H", "H", "H", ".", "H", ".", ".", ".", ".", ".", ".", ".", ".", ".", "H", ".", ".", ".", "H", ".", "H"],
		["H", "I", ".", ".", "X", ".", "H", ".", "H", "H", ".", ".", ".", ".", ".", ".", ".", ".", "H", ".", ".", ".", ".", ".", "H", ".", "?", ".", ".", "H", ".", ".", ".", ":", ":", ".", ".", "H", ".", "H", ".", "H", ".", ".", "H", "H", ".", "H", ".", ".", ".", ".", ".", "H", ".", "H", "H", "H", ".", "H"],
		["H", "H", "H", ".", "!", ".", "H", ".", "H", ".", ".", "H", "H", ".", ".", ".", ".", "$", "H", ".", ".", ".", ".", ".", "H", ".", ".", ".", ".", "H", ".", ".", ":", ".", ".", ":", ".", "H", ".", ".", ".", ".", ".", "H", ".", "H", ".", "H", "H", "H", "H", "H", ".", "H", "H", "H", "?", ".", ".", "H"],
		["H", ".", ".", "H", "#", "H", ".", ".", "H", ".", ".", ".", "H", "H", ".", ".", ".", ".", "H", ".", ".", "H", "H", ".", ".", "H", "H", ".", ".", ".", ".", "H", "H", "H", "H", ".", "H", "H", ".", "H", "H", "H", "H", ".", ".", "H", ".", "H", ".", ".", ".", ".", ".", "P", ".", ".", ".", ":", ":", "H"],
		["H", ".", ".", ".", ".", ".", ".", ".", "H", ".", ".", ".", ".", "H", "H", ".", "H", ".", ".", "H", ".", ".", "H", "H", ".", ".", "H", ".", ".", ".", "H", ".", "H", ".", ".", ".", ".", ".", ".", ".", ".", ".", ".", ".", "H", "H", ".", ".", ".", ".", ".", ".", "H", "H", "H", "H", "H", "H", "H", "H"],
		["H", ".", ".", "H", ".", "H", ".", ".", "H", ".", "H", "H", ".", "H", ".", ".", "H", "H", ".", "H", ".", "H", "H", ".", ".", "H", ".", ".", ".", ".", "H", ".", ".", ".", "H", ".", ".", "H", ".", ".", ".", "H", ".", "H", ".", ".", ".", ".", ".", ":", ".", "H", ".", ".", ".", ".", ".", ".", ".", "H"],
		["H", ".", "H", ".", ".", "H", ".", ".", "H", ".", "$", "H", ".", "H", ".", ".", "H", ".", ".", "H", ".", ".", "H", "H", ".", "H", "H", ".", ".", "H", ".", ".", "H", "H", "H", "H", "H", ".", ".", ".", "H", "H", ".", "H", "H", ".", ".", ".", ":", ".", ":", ".", "H", ".", ".", "H", "_", "H", ".", "H"],
		["H", ".", "@", "H", ".", ".", "H", ".", "H", ".", ".", ".", ".", "H", ".", ".", "H", ".", ".", "H", ".", "H", "H", "@", ".", ".", ".", ".", ".", ".", "H", ".", ".", ".", "H", ".", ".", ".", ".", "H", "H", ".", ".", ".", "H", "H", ".", ".", ".", ":", ".", "H", "?", ".", ".", "H", "H", "H", ":", "H"],
		["H", ".", ".", ".", "H", ".", "H", ".", "H", "H", "H", ".", ".", ".", ".", ".", ".", "H", ".", ".", ".", ".", "H", ".", ".", ".", ".", ".", ".", "H", ".", ".", "H", ".", ".", ".", "H", ".", "H", "H", ".", ".", ".", ".", ".", "H", "H", ".", ".", ".", ".", ".", "H", "H", ".", ".", ".", ".", ".", "H"],
		["H", ".", ".", "H", ".", ".", "H", ".", ".", ".", ".", "H", "H", ".", ".", ".", "H", "H", "H", "H", "H", "H", "H", "H", "H", "H", "H", "H", "H", "H", "H", ".", "H", "H", "H", "H", "H", ":", "H", ".", ".", ".", "H", ".", ".", ".", "H", ".", ".", ".", ".", ".", "H", "H", ".", ".", ".", ".", ".", "H"],
		["H", ".", "H", ".", ".", ".", ".", "H", ".", ".", ".", ".", "H", "H", ".", ".", "H", ".", ".", ".", "_", ".", ".", ".", ":", ".", ":", ".", ".", ".", "H", ".", ".", ".", ".", ".", "H", ".", "H", ".", ".", "H", ".", "T", ".", ".", ".", ".", ".", ".", ".", ".", ".", ".", "H", ".", ".", ".", ".", "H"],
		["H", ".", ".", ".", ".", ".", ".", ".", ".", ".", ".", ".", ".", "H", "H", ".", "H", ".", ".", "H", "#", "H", ".", ":", ".", ":", ".", ".", ".", ".", "H", ".", ".", "H", "H", ".", "H", ":", "H", ".", "H", ".", "H", "_", "H", ".", ".", ".", ".", ".", ".", ".", ".", ".", "H", ".", ".", ".", ".", "H"],
		["H", ".", ".", "H", "H", ".", ".", "H", "H", ".", "H", "H", "H", ".", "H", ".", "H", ".", "H", ".", ".", ".", "H", "H", "H", "H", "H", "H", "?", "H", "H", "H", "H", ".", ".", ".", "H", ".", "H", ".", ".", ".", "H", ".", ".", ".", ".", ".", ".", "H", "#", "H", "H", "H", "H", ".", ".", ".", ".", "H"],
		["H", ".", "H", ".", "?", "H", ".", "H", ".", ".", ".", ".", "H", ".", "H", "#", "H", ".", "H", ".", "S", ".", ".", "H", ".", ".", ".", ".", "H", "H", ".", ".", ".", "H", ".", ".", ".", ".", "H", ".", ".", ".", "H", ".", ".", ".", ".", ".", "H", "H", ".", ".", ".", "H", "H", ".", ":", ".", ".", "H"],
		["H", ".", "H", ".", ".", ".", ".", "H", "H", "H", "H", ".", "H", ".", ".", ".", ".", ".", "H", ".", ".", ".", "H", ".", ".", "H", ".", "H", ".", ".", ".", ".", ".", "H", ".", "H", "H", "H", "H", ".", ".", ".", "H", ".", ".", ".", ".", ".", "H", "@", ":", ":", ".", "H", "H", ".", ":", ".", ".", "H"],
		["H", ".", ".", "H", "H", ".", ".", "H", ".", ".", ".", ".", "H", "H", "H", "H", ":", ":", ".", "H", ".", "H", ".", ".", ".", ".", ".", "H", ".", "H", "H", ".", ".", "H", ".", "H", ":", ".", ":", ".", ".", ".", ".", ".", ".", ".", "H", "H", "H", ":", ".", ".", ".", ".", ".", ".", ":", ".", ".", "H"],
		["H", ".", ".", ".", ".", "H", ".", "H", ".", "H", "H", "H", "H", ".", ".", ".", ".", ".", "H", ".", ".", ".", ".", ".", "H", ".", "H", "H", ".", ".", "H", ".", ".", ".", ".", ".", ":", ".", ":", ".", ".", ".", ".", ".", ".", ".", "H", ".", ".", ".", ".", ".", ".", ".", ".", ":", ".", ".", ".", "H"],
		["H", ".", "H", "?", ".", "H", ".", "H", ".", ".", ".", ".", "H", ".", ".", ".", ".", "H", ".", ".", "?", ".", "H", ".", ".", ".", ".", "H", "H", ".", "H", ".", ".", ".", ".", ".", ":", ".", ":", ".", ".", ".", ".", ".", ".", ".", "H", ".", "?", ".", ".", "H", ".", ".", ".", ".", ".", ".", ".", "H"],
		["H", ".", ".", "H", "H", ".", ".", "H", "H", ".", "H", "H", "H", ".", ".", ".", ".", "H", ".", ".", ".", ".", ".", ".", ".", "H", ".", ".", ".", ".", "H", "H", "H", "H", "H", "H", "H", ".", ":", ".", ".", ".", ".", ".", ".", ".", "H", ".", ".", ".", ".", ".", ".", ".", ".", ".", ".", ".", ".", "H"],
		["H", ".", ".", ".", ".", ".", ".", ".", "H", ".", ".", ".", ".", ".", ".", ".", ".", "H", ".", ".", ".", ".", ".", ".", ".", ".", ".", ".", ".", ".", ".", ".", ".", "H", ".", ".", ":", ".", ":", ".", ".", ".", ".", ".", ".", ".", "H", ".", ".", "H", ".", ".", ".", "H", ".", ".", ".", ".", ".", "H"],
		["H", "H", "H", "H", "H", "H", "H", "H", "H", "H", "H", "H", "H", "H", "H", "H", "H", "H", "H", "H", "H", "H", "H", "H", "H", "H", "H", "H", "H", "H", "H", "H", "H", "H", "H", "H", "H", "H", "H", "H", "H", "H", "H", "H", "H", "H", "H", "H", "H", "H", "H", "H", "H", "H", "H", "H", "H", "H", "H", "H"]
	],
	"BackCover": "/Resources/Media/Images/Locations/WaterTemple/Way.svg",
	"BattleBack": "/Resources/Media/Images/Battle/Background/WaterTemple.svg",
	"MusicPeace": "/Resources/Media/OST/Music/WaterTemple/Peace.mp3",
	"MusicFight": "/Resources/Media/OST/Music/WaterTemple/Fight.mp3",
	"Start": {
		"X": 51,
		"Y": 34
	},
	"Danger": {
		"IsZero": false,
		"X": 12,
		"Y": 48
	},
	"IsTimeChamber": false,
	"StageFoes": [4, 5, 6, 7],
	"Bosses": {
		"4:17": 13
	},
	"Messages": {
		"17:17": "\u041D\u0430\u0439\u0434\u0435\u043D\u044B \u0027\u0414\u0440\u0435\u0432\u043D\u0438\u0435 \u0434\u043E\u0441\u043F\u0435\u0445\u0438\u0027",
		"10:21": "\u041D\u0430\u0439\u0434\u0435\u043D\u044B \u0027\u0421\u0430\u043F\u043E\u0433\u0438 \u043C\u0443\u0436\u0435\u0441\u0442\u0432\u0430\u0027",
		"24:10": "\u041D\u0430\u0439\u0434\u0435\u043D \u0027\u0414\u0440\u0435\u0432\u043D\u0438\u0439 \u043A\u0438\u043D\u0436\u0430\u043B\u0027",
		"8:9": "\u041D\u0430\u0439\u0434\u0435\u043D\u044B \u0027\u041F\u043E\u043D\u043E\u0436\u0438 \u0432\u043E\u0438\u043D\u0430\u0027",
		"56:5": "\u041D\u0430\u0439\u0434\u0435\u043D\u044B \u0027\u0428\u0442\u0430\u043D\u044B \u043A\u0440\u0443\u0442\u043E\u0433\u043E\u0027",
		"1:16": "\u041D\u0430\u0439\u0434\u0435\u043D\u044B \u0027\u0410\u0440\u043C\u0435\u0439\u0441\u043A\u0438\u0435 \u0431\u043E\u0442\u0438\u043D\u043A\u0438\u0027",
		"49:29": "\u041E\u0441\u0442\u0430\u0432\u0448\u0438\u0439\u0441\u044F \u043F\u0443\u0442\u043D\u0438\u043A, \u0441\u043A\u0432\u043E\u0437\u044C \u0432\u0440\u0435\u043C\u044F \u043F\u0440\u043E\u0439\u0434\u044F...",
		"23:22": "\u041B\u0435\u0442\u0435\u043B \u043A \u0441\u0432\u043E\u0435\u0439 \u0446\u0435\u043B\u0438, \u043D\u043E \u043D\u0430\u0432\u0437\u043D\u0438\u0447\u044C \u043E\u043D \u043F\u0430\u043B.",
		"2:22": "\u041E\u043A\u0443\u0442\u0430\u043D\u043D\u044B\u0439 \u043C\u0433\u043B\u043E\u0439 \u0437\u0430 \u043D\u0438\u043C \u043D\u0430\u0431\u043B\u044E\u0434\u0430\u043B..."
	},
	"Gates": {
		"54:5": {
			"X": 54,
			"Y": 4
		},
		"2:8": {
			"X": 4,
			"Y": 18
		},
		"56:21": {
			"X": 50,
			"Y": 27
		},
		"20:25": {
			"X": 20,
			"Y": 26
		},
		"43:26": {
			"X": 15,
			"Y": 28
		}
	},
	"Warps": {
		"43:25": {
			"X": 56,
			"Y": 4
		}
	},
	"Equipment": {
		"17:17": {
			"Kind": 1,
			"Set": 2
		},
		"10:21": {
			"Kind": 3,
			"Set": 2
		},
		"24:10": {
			"Kind": 0,
			"Set": 2
		},
		"8:9": {
			"Kind": 2,
			"Set": 2
		},
		"56:5": {
			"Kind": 2,
			"Set": 4
		},
		"1:16": {
			"Kind": 3,
			"Set": 4
		}
	},
	"TileCodes": {
		"?": "/Resources/Media/Images/Locations/Total/Surprise.svg",
		"H": "/Resources/Media/Images/Locations/WaterTemple/Wall.svg",
		"T": "/Resources/Media/Images/Locations/WaterTemple/Wall.svg",
		"P": "/Resources/Media/Images/Locations/WaterTemple/Wall.svg",
		"X": "/Resources/Media/Images/Locations/WaterTemple/Artifact.svg",
		".": "/Resources/Media/Images/Locations/Total/Transparent.svg",
		":": "/Resources/Media/Images/Locations/Total/Spikes.svg",
		"_": "/Resources/Media/Images/Locations/Total/Button.svg",
		"!": "/Resources/Media/Images/Locations/Total/Transparent.svg",
		"I": "/Resources/Media/Images/Locations/Total/Transparent.svg",
		"S": "/Resources/Media/Images/Locations/Total/SafeArea.svg",
		"$": "/Resources/Media/Images/Locations/Total/Chest/Closed.svg",
		"E": "/Resources/Media/Images/Locations/Total/Chest/Opened.svg",
		"K": "/Resources/Media/Images/Locations/Total/Key.svg",
		"#": "/Resources/Media/Images/Locations/Total/Lock.svg",
		"@": "/Resources/Media/Images/Locations/Total/Table.svg"
	}
}