{
	"Name": "\u0425\u0440\u0430\u043C \u0432\u043E\u0434\u044B",
	"NextChapter": "FireTemple",
	"Map": [
		["H", "H", "H", "H", "H", "H", "H", "H", "H", "H", "H", "H", "H", "H", "H", "H", "H", "H", "H", "H", "H", "H", "H", "H", "H", "H", "H", "H", "H", "H", "H", "H", "H", "H", "H", "H", "H", "H", "H", "H", "H", "H", "H", "H", "H", "H", "H", "H", "H", "H", "H", "H", "H", "H", "H", "H", "H", "H", "H", "H"],
		["H", ".", ".", ".", "H", ".", ".", ".", ".", ".", ".", "H", ".", ".", ".", ".", "H", ".", ".", "H", ".", "H", ".", ".", ".", ".", ".", ".", ".", ".", ".", ".", ".", ".", ".", ".", ".", ".", ".", ".", ".", ".", ".", ".", ".", "H", ".", ".", ".", ".", ".", ".", ".", "H", ".", ".", ".", ".", ".", "H"],
		["H", ".", "H", ".", "H", ".", ".", ".", ".", ".", ".", "H", ".", "H", ".", ".", ".", "H", ".", ".", ".", "H", ".", ".", ".", ".", "H", ".", ".", ".", ".", ".", ".", ".", ".", "H", "H", "H", "H", ".", "H", "H", "H", "H", "H", ".", ".", "H", "H", "H", ".", ".", ".", "H", "H", "H", ".", ".", ".", "H"],
		["H", ".", "H", ".", ".", ".", ".", ".", ".", ".", ".", "H", ".", ".", ".", "H", ".", ".", ".", "H", ".", "H", ".", ".", ".", "H", "H", "H", ".", ".", "H", ".", ".", ".", "H", ".", ".", ".", ".", ".", ".", ".", ".", ".", ".", "H", ".", ".", ".", "H", ".", ".", ".", "H", "B", "H", ".", ".", ".", "H"],
		["H", ".", "H", "H", "H", "H", ".", "H", "H", "H", ".", "H", ".", "H", "H", "H", "H", "H", "H", "H", ".", "H", ".", ".", ".", ".", "H", ".", ".", "H", "H", ".", ".", ".", ".", "H", "H", "H", "H", "H", "H", "H", "H", "H", ".", "H", ".", ".", "H", ".", ".", "H", ".", "H", "#", "H", ".", "H", ".", "H"],
		["H", ".", ".", ".", ".", "H", ".", ".", ".", "H", ".", "H", ".", ".", ".", ".", ".", ".", ".", "H", ".", "H", ".", ".", ".", ".", ".", ".", ".", ".", ".", ".", ".", "H", "H", ".", ".", ".", ".", ".", ".", ".", ".", ".", ".", ".", "H", ".", ".", ".", ".", "H", ".", ".", "_", "H", "$", "H", ".", "H"],
		["H", ".", ".", "H", "H", ".", ".", "H", "H", "H", ".", "H", "H", "H", "H", "H", "H", "H", ".", "H", ".", "H", ".", ".", ".", ".", ".", ".", ".", "H", "H", ".", "H", ".", ".", "H", "H", "H", ".", "H", "H", "H", "H", "H", ".", "H", ".", ".", "H", "H", "H", "H", ".", "H", ".", "H", "H", "H", ".", "H"],
		["H", ".", ".", ".", "H", ".", ".", ".", ".", ".", ".", ":", ":", ".", ".", ".", ".", ".", ".", "H", ".", ".", ".", ".", ".", ".", ".", ".", ".", ".", ".", ".", "H", ".", ".", ".", "H", ".", ".", ".", ".", ".", "H", ".", "H", ".", ".", ".", ".", "H", "H", ".", ".", "H", ".", "H", ".", "H", ".", "H"],
		["H", ".", "_", ":", ".", "H", ".", ":", "H", ".", "H", ".", ":", ":", ".", ".", ".", ".", "H", "H", "H", "H", ".", ".", "H", ".", ".", "H", "H", "H", "H", "H", ".", ".", "H", ".", "P", ".", "H", ".", "H", ".", ".", ".", ".", "H", "H", ".", ".", ".", ".", ".", ".", "H", ".", "H", ".", "H", ".", "H"],
		["H", ".", ".", "H", "H", ":", ".", "H", "$", "H", ".", ".", ":", ":", "H", "H", "H", "H", "H", ".", ".", "H", ".", ".", "H", ".", ".", "H", ".", ".", ".", ".", ".", ".", "H", "H", "H", ".", "H", "H", "H", "H", ".", ".", ".", "H", ".", ".", "H", ".", ".", "H", ".", "H", ".", "H", ".", ".", ".", "H"],
		["H", ".", "H", ".", ".", ".", ".", "H", ".", "H", "H", "H", "H", "H", "H", ".", "H", ".", ".", ".", ".", ".", "H", "H", "$", "H", "H", ".", ".", ".", ".", ".", ":", ".", ":", ":", ".", "H", ".", "H", ".", ".", ".", ".", ".", "H", ".", ".", "H", "H", "H", "H", ".", "H", ".", "H", ".", "H", ".", "H"],
		["H", ".", ":", "H", "H", ".", "H", ".", ".", ".", ".", "H", ".", ".", ".", ".", "H", ".", ".", ".", "H", ".", ".", ":", ".", ":", ".", ".", "H", ".", ".", ".", ":", ":", ".", ":", ".", "H", ".", ".", ".", "H", ".", ".", ".", "H", "H", ".", "H", ".", ".", "H", ".", "H", ".", "H", ".", "H", ".", "H"],
		["H", ":", ":", ".", ".", ".", ".", "H", ".", "H", ".", ".", ".", "H", ".", ".", "H", ".", ".", ".", ".", ".", ":", ".", "H", ".", ":", ".", ".", ".", ".", ".", ".", ".", ".", ".", ".", "H", ".", "H", "H", "H", "H", "H", "H", ".", ".", ".", "H", ".", ".", "H", ".", "H", ".", "H", ".", "H", ".", "H"],
		["H", ".", ".", ".", ".", ".", ".", "H", "H", "H", "H", "H", ".", "H", ".", ".", "H", ".", ".", ".", ".", "H", ".", ".", "H", ".", ".", "H", ".", ".", ".", ".", ".", ".", ".", ".", ".", "H", ".", ".", ".", ".", ".", "H", ".", ".", ".", ".", ".", ".", ".", ".", ".", "H", ".", "H", ".", "H", ".", "H"],
		["H", ".", ".", "H", "H", "H", ".", ".", ".", "H", ".", ".", ".", "H", ".", ".", "H", ".", ".", ".", ".", ".", ".", ".", "H", ".", ".", ".", "H", ".", ".", ".", ".", ":", ":", ".", ".", ".", "H", "H", ".", ".", ".", "H", ".", "H", "H", "H", "H", "H", "H", "H", "H", "H", ".", "H", ".", "H", ".", "H"],
		["H", "P", "H", ".", ".", ".", "H", ".", ".", "H", ".", ".", "H", "H", ".", ".", ".", "H", "H", ".", ".", ".", "H", ".", "H", ".", "H", ".", ".", "H", ".", ".", ":", ".", ".", ":", ".", "H", ".", "H", "H", "H", ".", "H", ".", ".", ".", ".", ".", ".", ".", ".", ".", "H", ".", ".", ".", "H", ".", "H"],
		["H", "I", ".", ".", "X", ".", "H", ".", "H", "H", ".", ".", ".", ".", ".", ".", ".", ".", "H", ".", ".", ".", ".", ".", "H", ".", ".", ".", ".", "H", ".", ".", ".", ":", ":", ".", ".", "H", ".", "H", ".", "H", ".", ".", "H", "H", ".", "H", ".", ".", ".", ".", ".", "H", ".", "H", "H", "H", ".", "H"],
		["H", "H", "H", ".", "!", ".", "H", ".", "H", ".", ".", "H", "H", ".", ".", ".", ".", "$", "H", ".", ".", ".", ".", ".", "H", ".", ".", ".", ".", "H", ".", ".", ":", ".", ".", ":", ".", "H", ".", ".", ".", ".", ".", "H", ".", "H", ".", "H", "H", "H", "H", "H", ".", "H", "H", "H", ".", ".", ".", "H"],
		["H", ".", ".", "H", "#", "H", ".", ".", "H", ".", ".", ".", "H", "H", ".", ".", ".", ".", "H", ".", ".", "H", "H", ".", ".", "H", "H", ".", ".", ".", ".", "H", "H", "H", "H", ".", "H", "H", ".", "H", "H", "H", "H", ".", ".", "H", ".", "H", ".", ".", ".", ".", ".", "P", ".", ".", ".", ":", ":", "H"],
		["H", ".", ".", ".", ".", ".", ".", ".", "H", ".", ".", ".", ".", "H", "H", ".", "H", ".", ".", "H", ".", ".", "H", "H", ".", ".", "H", ".", ".", ".", "H", ".", "H", ".", ".", ".", ".", ".", ".", ".", ".", ".", ".", ".", "H", "H", ".", ".", ".", ".", ".", ".", "H", "H", "H", "H", "H", "H", "H", "H"],
		["H", ".", ".", "H", ".", "H", ".", ".", "H", ".", "H", "H", ".", "H", ".", ".", "H", "H", ".", "H", ".", "H", "H", ".", ".", "H", ".", ".", ".", ".", "H", ".", ".", ".", "H", ".", ".", "H", ".", ".", ".", "H", ".", "H", ".", ".", ".", ".", ".", ":", ".", "H", ".", ".", ".", ".", ".", ".", ".", "H"],
		["H", ".", "H", ".", ".", "H", ".", ".", "H", ".", "$", "H", ".", "H", ".", ".", "H", ".", ".", "H", ".", ".", "H", "H", ".", "H", "H", ".", ".", "H", ".", ".", "H", "H", "H", "H", "H", ".", ".", ".", "H", "H", ".", "H", "H", ".", ".", ".", ":", ".", ":", ".", "H", ".", ".", "H", "_", "H", ".", "H"],
		["H", ".", "@", "H", ".", ".", "H", ".", "H", ".", ".", ".", ".", "H", ".", ".", "H", ".", ".", "H", ".", "H", "H", "@", ".", ".", ".", ".", ".", ".", "H", ".", ".", ".", "H", ".", ".", ".", ".", "H", "H", ".", ".", ".", "H", "H", ".", ".", ".", ":", ".", "H", ".", ".", ".", "H", "H", "H", ":", "H"],
		["H", ".", ".", ".", "H", ".", "H", ".", "H", "H", "H", ".", ".", ".", ".", ".", ".", "H", ".", ".", ".", ".", "H", ".", ".", ".", ".", ".", ".", "H", ".", ".", "H", ".", ".", ".", "H", ".", "H", "H", ".", ".", ".", ".", ".", "H", "H", ".", ".", ".", ".", ".", "H", "H", ".", ".", ".", ".", ".", "H"],
		["H", ".", ".", "H", ".", ".", "H", ".", ".", ".", ".", "H", "H", ".", ".", ".", "H", "H", "H", "H", "H", "H", "H", "H", "H", "H", "H", "H", "H", "H", "H", ".", "H", "H", "H", "H", "H", ":", "H", ".", ".", ".", "H", ".", ".", ".", "H", ".", ".", ".", ".", ".", "H", "H", ".", ".", ".", ".", ".", "H"],
		["H", ".", "H", ".", ".", ".", ".", "H", ".", ".", ".", ".", "H", "H", ".", ".", "H", ".", ".", ".", "_", ".", ".", ".", ":", ".", ":", ".", ".", ".", "H", ".", ".", ".", ".", ".", "H", ".", "H", ".", ".", "H", ".", "T", ".", ".", ".", ".", ".", ".", ".", ".", ".", ".", "H", ".", ".", ".", ".", "H"],
		["H", ".", ".", ".", ".", ".", ".", ".", ".", ".", ".", ".", ".", "H", "H", ".", "H", ".", ".", "H", "#", "H", ".", ":", ".", ":", ".", ".", ".", ".", "H", ".", ".", "H", "H", ".", "H", ":", "H", ".", "H", ".", "H", "_", "H", ".", ".", ".", ".", ".", ".", ".", ".", ".", "H", ".", ".", ".", ".", "H"],
		["H", ".", ".", "H", "H", ".", ".", "H", "H", ".", "H", "H", "H", ".", "H", ".", "H", ".", "H", ".", ".", ".", "H", "H", "H", "H", "H", "H", ".", "H", "H", "H", "H", ".", ".", ".", "H", ".", "H", ".", ".", ".", "H", ".", ".", ".", ".", ".", ".", "H", "#", "H", "H", "H", "H", ".", ".", ".", ".", "H"],
		["H", ".", "H", ".", ".", "H", ".", "H", ".", ".", ".", ".", "H", ".", "H", "#", "H", ".", "H", ".", "S", ".", ".", "H", ".", ".", ".", ".", "H", "H", ".", ".", ".", ".", ".", ".", ".", ".", "H", ".", ".", ".", "H", ".", ".", ".", ".", ".", "H", "H", ".", ".", ".", "H", "H", ".", ":", ".", ".", "H"],
		["H", ".", "H", ".", ".", ".", ".", "H", "H", "H", "H", ".", "H", ".", ".", ".", ".", ".", "H", ".", ".", ".", "H", ".", "H", "H", ".", "H", ".", ".", "H", ".", ".", ".", ".", "H", "H", "H", "H", ".", ".", ".", "H", ".", ".", ".", ".", ".", "H", "@", ":", ":", ".", "H", "H", ".", ":", ".", ".", "H"],
		["H", ".", ".", "H", "H", ".", ".", "H", ".", ".", ".", ".", "H", "H", "H", "H", ":", ":", ".", "H", ".", "H", ".", ".", "H", ".", ".", "H", ".", "H", "H", ".", ".", ".", ".", "H", ":", ".", ":", ".", ".", ".", ".", ".", ".", ".", "H", "H", "H", ":", ".", ".", ".", ".", ".", ".", ":", ".", ".", "H"],
		["H", ".", ".", ".", ".", "H", ".", "H", ".", "H", "H", "H", "H", ".", ".", ".", ".", ".", "H", ".", ".", ".", ".", ".", "H", ".", ".", "H", ".", ".", "H", ".", ".", ".", ".", ".", ":", ".", ":", ".", ".", ".", ".", ".", ".", ".", "H", ".", ".", ".", ".", ".", ".", ".", ".", ":", ".", ".", ".", "H"],
		["H", ".", "H", ".", ".", "H", ".", "H", ".", ".", ".", ".", "H", ".", ".", ".", ".", "H", ".", ".", ".", ".", ".", ".", "H", ".", ".", "H", "H", ".", "H", ".", ".", ".", ".", ".", ":", ".", ":", ".", ".", ".", ".", ".", ".", ".", "H", ".", ".", ".", ".", "H", ".", ".", ".", ".", ".", ".", ".", "H"],
		["H", ".", ".", "H", "H", ".", ".", "H", "H", ".", "H", "H", "H", ".", ".", ".", ".", "H", ".", ".", ".", ".", ".", ".", "H", ".", ".", ".", ".", ".", "H", ".", ".", ".", ".", ".", ":", ".", ":", ".", ".", ".", ".", ".", ".", ".", "H", ".", ".", ".", ".", ".", ".", ".", ".", ".", ".", ".", ".", "H"],
		["H", ".", ".", ".", ".", ".", ".", ".", "H", ".", ".", ".", ".", ".", ".", ".", ".", "H", ".", ".", ".", ".", ".", ".", "H", ".", ".", ".", ".", ".", "H", ".", ".", ".", ".", ".", ":", ".", ":", ".", ".", ".", ".", ".", ".", ".", "H", ".", ".", "H", ".", ".", ".", "H", ".", ".", ".", ".", ".", "H"],
		["H", "H", "H", "H", "H", "H", "H", "H", "H", "H", "H", "H", "H", "H", "H", "H", "H", "H", "H", "H", "H", "H", "H", "H", "H", "H", "H", "H", "H", "H", "H", "H", "H", "H", "H", "H", "H", "H", "H", "H", "H", "H", "H", "H", "H", "H", "H", "H", "H", "H", "H", "H", "H", "H", "H", "H", "H", "H", "H", "H"]
	],
	"BackCover": "/Resources/Media/Images/Locations/WaterTemple/Way.svg",
	"BattleBack": "/Resources/Media/Images/Battle/Background/WaterTemple.svg",
	"MusicPeace": "/Resources/Media/OST/Music/WaterTemple/Peace.mp3",
	"MusicFight": "/Resources/Media/OST/Music/WaterTemple/Fight.mp3",
	"Start": {
		"X": 51,
		"Y": 34
	},
	"Danger": {
		"X": 48,
		"Y": 12
	},
	"StageFoes": [4, 5, 6, 7],
	"Bosses": {
		"4:17": 13
	},
	"Messages": null,
	"Gates": {
		"54:5": {
			"X": 54,
			"Y": 4
		},
		"2:8": {
			"X": 4,
			"Y": 18
		},
		"56:21": {
			"X": 50,
			"Y": 27
		},
		"20:25": {
			"X": 20,
			"Y": 26
		},
		"43:26": {
			"X": 15,
			"Y": 28
		}
	},
	"Warps": {
		"43:25": {
			"X": 56,
			"Y": 4
		}
	},
	"Equipment": {
		"17:17": {
			"Kind": 1,
			"Set": 2
		},
		"10:21": {
			"Kind": 3,
			"Set": 2
		},
		"24:10": {
			"Kind": 0,
			"Set": 2
		},
		"8:9": {
			"Kind": 2,
			"Set": 2
		},
		"56:5": {
			"Kind": 2,
			"Set": 4
		},
		"1:16": {
			"Kind": 3,
			"Set": 4
		}
	},
	"TileCodes": {
		"H": "/Resources/Media/Images/Locations/WaterTemple/Wall.svg",
		"T": "/Resources/Media/Images/Locations/WaterTemple/Wall.svg",
		"P": "/Resources/Media/Images/Locations/WaterTemple/Wall.svg",
		"X": "/Resources/Media/Images/Locations/WaterTemple/Artifact.svg",
		".": "/Resources/Media/Images/Locations/Total/Transparent.svg",
		":": "/Resources/Media/Images/Locations/Total/Spikes.svg",
		"_": "/Resources/Media/Images/Locations/Total/Button.svg",
		"!": "/Resources/Media/Images/Locations/Total/Transparent.svg",
		"?": "/Resources/Media/Images/Locations/Total/Surprise.svg",
		"I": "/Resources/Media/Images/Locations/Total/Transparent.svg",
		"S": "/Resources/Media/Images/Locations/Total/SafeArea.svg",
		"$": "/Resources/Media/Images/Locations/Total/Chest/Closed.svg",
		"E": "/Resources/Media/Images/Locations/Total/Chest/Opened.svg",
		"K": "/Resources/Media/Images/Locations/Total/Key.svg",
		"#": "/Resources/Media/Images/Locations/Total/Lock.svg",
		"@": "/Resources/Media/Images/Locations/Total/Table.svg"
	}
}