{
	"NextChapter": "TimeChamber",
	"Map": [
		["H", "H", "H", "H", "H", "H", "H", "H", "H", "H", "H", "H", "H", "H", "H", "H", "H", "H", "H", "H", "H", "H", "H", "H", "H", "H", "H", "H", "H", "H", "H", "H", "H", "H", "H", "H", "H", "H", "H", "H", "H", "H", "H", "H", "H", "H", "H", "H", "H", "H", "H", "H", "H", "H", "H", "H", "H", "H", "H", "H"],
		["H", ".", ".", ".", ".", ".", ".", ".", ".", ".", ".", ".", ".", ".", ".", ".", ".", ".", "H", "H", ".", ".", ".", ".", ":", ":", "H", ".", ".", ".", "H", ":", ":", ".", ".", ".", ".", ".", ".", ".", "H", "H", ".", ".", ".", ".", ".", ".", ".", ".", ".", ".", ".", ".", ".", ".", ".", ".", ".", "H"],
		["H", ".", ".", ".", ".", ".", "?", "?", "?", "?", "?", "?", "?", ".", ".", ".", ".", ".", "H", "H", ".", ".", ".", ".", ":", ":", "H", ".", "X", ".", "H", ":", ":", ".", ".", ".", ".", ".", ".", ".", "H", "H", ".", ".", ".", ".", ".", "?", "?", "?", "?", "?", "?", ".", ".", ".", ".", ".", ".", "H"],
		["H", ".", ".", ".", ".", "?", "?", "?", "?", "?", "?", "?", ".", ".", ".", ".", ".", ".", "H", "H", ".", "H", ".", ".", ":", ":", "H", ".", "!", ".", "H", ":", ":", ".", ".", "H", ".", "H", "H", ".", "H", "H", ".", ".", ".", ".", ".", ".", ".", ".", ".", ".", ".", ".", ".", ".", ".", ".", ".", "H"],
		["H", ".", ".", ".", ".", ".", ".", ".", ".", ".", ".", ".", ".", ".", ".", ".", ".", ".", "H", "H", ".", "H", ".", ".", ":", ":", ":", "H", ".", "H", ":", ":", ":", ".", ".", "H", ".", "H", ".", ".", "H", "H", ".", ".", ":", ":", ".", ".", ".", "H", "H", "H", ".", ".", ".", ":", ":", ".", ".", "H"],
		["H", ".", ".", ":", ":", ".", ".", ".", "H", "H", "H", ".", ".", ".", ":", ":", ".", ".", "H", "H", ".", "H", ".", ".", ".", ":", ":", ":", ".", ":", ":", ":", ".", ".", ".", "H", ".", "H", ".", ".", "H", "H", ".", ".", ":", ":", ".", ".", "H", ".", ".", ".", "H", ".", ".", ":", ":", ".", ".", "H"],
		["H", ".", ".", ":", ":", ".", ".", "H", ".", ".", ".", "H", ".", ".", ":", ":", ".", ".", "H", "H", ".", "H", "H", ".", ".", ".", ":", ":", ".", ":", ":", ".", ".", ".", "H", "H", ".", ".", ".", ".", "H", "H", ":", ":", "?", "?", ":", ":", "H", ".", "@", ".", "H", ":", ":", "?", "?", ":", ":", "H"],
		["H", ":", ":", "?", "?", ":", ":", "H", ".", "@", ".", "H", ":", ":", "?", "?", ":", ":", "H", "H", ".", ".", "H", "H", ".", ".", ".", ".", ".", ".", ".", ".", ".", "H", "H", ".", ".", ".", "H", ".", "H", "H", ":", ":", "?", "?", ":", ":", "H", ".", ".", ".", "H", ":", ":", "?", "?", ":", ":", "H"],
		["H", ":", ":", "?", "?", ":", ":", "H", ".", ".", ".", "H", ":", ":", "?", "?", ":", ":", "H", "H", ".", ".", ".", "H", "H", ".", ".", ".", ".", ".", ".", ".", "H", "H", ".", ".", ".", ".", "H", ".", "H", "H", ".", ".", ":", ":", ".", ".", ".", "H", ".", "H", ".", ".", ".", ":", ":", ".", ".", "H"],
		["H", ".", ".", ":", ":", ".", ".", ".", "H", ".", "H", ".", ".", ".", ":", ":", ".", ".", "/", ".", ".", ".", ".", ".", "H", "H", ".", ".", ".", ".", ".", "H", "H", ".", ".", ".", ".", "H", "H", ".", ".", "/", ".", ".", ":", ":", ".", ".", ".", ".", ".", ".", ".", ".", ".", ":", ":", ".", ".", "H"],
		["H", ".", ".", ":", ":", ".", ".", ".", ".", ".", ".", ".", ".", ".", ":", ":", ".", ".", "H", "H", ".", ".", ".", ".", ".", "H", "H", "H", ".", "H", "H", "H", ".", ".", ".", ".", ".", ".", ".", ".", "H", "H", ".", ".", ".", ".", ".", ".", ".", ".", ".", ".", ".", "H", "H", "H", "H", "H", "H", "H"],
		["H", ".", ".", ".", ".", ".", ".", "?", "?", "?", "?", "?", ".", ".", ".", ".", ".", ".", "H", "H", ".", "?", ":", "?", ".", ".", ".", ".", ".", ".", ".", ".", ".", ".", "?", ".", ".", ".", ".", ".", "H", "H", ".", ".", "?", ".", ".", ".", ".", ".", ".", ".", ".", "H", ".", ".", ".", ".", ".", "H"],
		["H", ".", ".", ".", ".", ".", ".", "?", "?", "?", "?", "?", ".", ".", ".", ".", ".", ".", "H", "H", ".", ":", "?", ":", ".", ".", ".", ".", ".", ".", ".", ".", ".", "?", ":", "?", ".", ".", ".", ".", "H", "H", ".", ".", "?", ".", ".", ".", "?", "?", ".", ".", ".", "H", ".", "?", ".", ".", ".", "H"],
		["H", ".", ".", ".", ".", ".", ".", ".", ".", ".", ".", ".", ".", ".", ".", ".", ".", ".", "H", "H", ".", "?", ":", "?", ".", ".", ".", ".", ".", ".", ".", ".", ".", ".", "?", ".", ".", ".", ".", ".", "H", "H", ".", ".", ".", ".", ".", "?", "?", "?", ".", ".", ".", "H", ".", ".", "H", ".", "?", "H"],
		["H", "H", "H", "H", "H", ".", ".", "H", "H", "H", "H", ":", ":", ":", ":", ":", ".", ".", "H", "H", ".", ".", ".", ".", ".", ".", ".", ".", ".", ".", ".", ".", ".", ".", ".", ".", ".", ".", ".", ".", "H", "P", "H", ".", ".", ".", "?", "?", "?", ".", ".", ".", ".", "H", ".", ".", "H", ".", ".", "H"],
		["H", ".", ".", ".", "H", "T", "H", "H", ".", ".", "H", ":", ":", ":", ":", "H", "H", "H", "H", "H", "H", "H", "H", "H", "H", "H", ".", ".", ".", ".", ".", "H", "H", "H", "H", "H", "H", "H", "H", "H", "H", "P", "H", "H", ".", ".", "?", "?", ".", ".", "H", "H", "H", "H", "H", "H", "H", ".", ".", "H"],
		["H", ".", "H", ".", ".", ".", "H", ".", ".", ".", "H", ".", ".", "H", "H", "H", ".", ".", ".", ".", ":", ":", ".", ".", ".", ".", "H", "H", "H", "H", "H", ".", ".", ".", ".", ".", ".", ".", ".", ".", ".", ".", ".", "H", "H", ".", ".", ".", ".", ".", "H", ".", ".", ".", ".", ".", ".", ".", ".", "H"],
		["H", ".", "H", ".", "$", ".", "H", ".", "H", ":", "H", "?", ".", "H", ".", ".", ".", ".", ".", ".", ".", ".", ".", ":", ":", ".", "H", "@", ".", ".", "H", ".", ":", ".", ":", ".", ":", ":", ":", ".", ":", ".", ":", ".", "H", "H", "H", "P", "H", "H", "H", ".", ".", ".", "H", "H", "H", ".", ".", "H"],
		["H", ".", "H", ".", ".", ".", "H", ".", "H", ":", ".", "H", "H", "H", ".", "?", ".", ".", ".", ".", ".", ":", ":", ".", ".", ".", ".", ".", "S", ".", ".", ".", ".", ":", ".", ":", ":", "?", ":", ":", ".", ":", ".", ".", ".", "H", "T", "P", "H", ".", ".", ".", ".", "H", ".", ".", ".", ".", ".", "H"],
		["H", ".", ".", "H", "H", "H", ".", ".", "H", ".", ".", "H", ".", ".", ".", ".", ".", ".", ".", ":", ":", ".", ".", ".", ".", ".", "H", ".", ".", ".", "H", ".", ":", ".", ":", ".", ":", ":", ":", ".", ":", ".", ":", ".", ".", "H", "H", "H", ".", ".", ".", "H", "H", "H", "H", ".", ".", ".", ".", "H"],
		["H", ".", ":", ".", ".", ".", ":", ":", "H", ":", "H", "H", ".", ".", ".", ".", ".", "H", "H", "H", "H", "H", "H", "H", "H", "H", "H", "H", ".", "H", "H", ".", ".", ".", ".", ".", ".", ".", ".", ".", ".", ".", ".", ".", ".", "H", "I", "H", ".", ":", ".", ".", ".", ".", ".", ".", ".", ".", ".", "H"],
		["H", ".", "H", "H", "H", "H", "H", ":", "H", ".", "H", ".", ".", "?", ".", "H", "H", "H", ".", ".", ".", "H", ".", ".", ".", ".", "H", ".", ".", ".", ".", "H", "H", "H", "H", "H", "H", "H", "H", "H", "H", ".", ".", ".", ".", ".", "H", "H", ":", "\u003E", ":", ".", ".", ".", ".", ".", ".", "H", "H", "H"],
		["H", ".", ":", ".", ".", "?", "H", ":", "H", ":", "H", ".", ".", ".", ".", "H", ".", ".", ".", "H", ".", "H", ".", "$", ".", ".", "H", ".", ":", ".", ".", ".", ".", ".", ".", ".", ".", ".", ".", ".", "H", "H", ".", ".", ".", ".", ".", "H", ".", ":", ".", ".", ".", "H", "H", "H", "H", ".", ".", "H"],
		["H", "H", "H", ".", "H", "H", "H", ":", "H", ".", "H", ".", ".", "H", "H", "H", ".", ".", ".", "H", ".", "H", ".", ".", ".", ".", "H", ":", ".", ".", ".", ".", ":", ".", ".", ":", ".", ":", ":", ".", ":", "H", "H", "?", ".", ".", ".", "H", "H", "H", "H", "H", ".", "H", ".", ".", ".", ".", ".", "H"],
		["H", ".", ":", ".", "H", ":", ":", ":", "H", ":", "H", ".", ".", "H", ".", ".", "H", ".", ".", "H", ".", "H", "H", "H", "H", ".", "H", ".", ":", ".", ".", "H", "H", "H", "H", "H", "H", ":", ":", ".", ".", ".", "H", "H", "H", "H", ".", "H", ".", ".", ".", ".", ".", "H", "H", "H", ".", ".", ".", "H"],
		["H", ".", "H", "H", "H", ":", "H", "H", "H", ".", "H", ".", ".", "H", ".", ".", ".", "H", ".", "H", ".", ".", ".", ".", ".", ".", "H", ".", ".", ":", ".", ".", ".", ".", ".", ".", "H", ".", ".", ".", "_", ".", ".", ".", ".", "H", ".", "H", ".", "H", "H", "H", "H", "H", ".", ".", ".", ".", ".", "H"],
		["H", ".", ":", ".", "H", ":", "H", ".", ".", ":", ".", ".", ".", ".", ".", ".", ".", "H", ".", "H", "H", "H", "H", "H", "H", "H", "H", ".", ":", ".", "H", "H", "H", "H", ".", ".", "H", ".", ".", ".", ".", ".", ".", "H", ".", "H", ".", "H", ".", ".", ".", ".", ".", "H", ".", ":", "$", ":", ".", "H"],
		["H", "H", "H", ".", "H", ":", "H", ":", ":", ".", "H", ".", ".", "H", "H", "H", ".", "H", ".", ".", ".", ".", ".", ".", ".", ".", "H", ":", ".", ".", "H", ".", ".", ".", ".", "H", ".", "H", "H", "H", ".", "H", ".", "H", ".", "H", ".", "H", ".", "H", ".", ".", ".", "H", ".", ".", ":", ".", ".", "H"],
		["H", ".", ".", ".", "H", ":", "H", ":", ":", ".", "H", ".", ".", ".", ".", "H", ".", "H", "H", "H", "?", "H", "H", "H", ".", ".", "H", ".", ":", ".", "H", ":", "H", "H", "H", ".", ".", "#", "$", "H", ".", "H", ".", ".", ".", "H", ".", "H", ".", "H", "H", ".", ".", "H", ".", ".", ".", ".", ".", "H"],
		["H", ".", ".", ":", "H", ":", "H", ":", ".", ":", "H", ".", ".", ".", ".", "H", "H", "H", "?", "H", "H", "H", "?", "H", ".", ".", "H", ".", ".", ":", "H", ".", "H", ".", ".", ".", ":", "H", "H", "H", ".", "H", "H", "H", ".", "H", ".", "H", ".", ".", "H", ".", ".", ".", ".", ".", ".", ".", ".", "H"],
		["H", ".", "H", ".", ":", ".", "H", ".", ":", ":", "H", ".", ".", ":", ".", ".", ".", ".", ".", ".", ".", ".", ".", ".", ".", ".", "H", ".", ".", ".", "H", ".", ".", ".", "H", ".", ".", "H", ".", ".", ".", ".", ".", ".", ".", "H", ".", "H", "H", ".", "H", ".", ".", ".", "H", ".", "H", "H", "H", "H"],
		["H", ".", "H", ":", ".", ":", "H", ".", ":", ":", "H", ".", ".", "H", "H", "H", "H", "H", "H", "H", "H", "H", "H", "H", "H", "H", "H", "H", ".", "H", "H", "H", "H", "H", "H", "H", "H", "H", "H", "H", "H", "H", "H", "H", ".", "H", ".", "?", "H", ":", "H", ".", ".", ".", "H", ".", ".", ".", ".", "H"],
		["H", ".", "H", "H", "H", "H", "H", ":", ".", ".", "H", ".", ".", "H", "?", "?", "?", "?", "?", "?", "?", "P", "P", "P", "P", ".", "?", ".", ".", ".", "?", ".", "P", "P", "P", "P", "?", "?", "?", "?", "?", "?", "?", "H", ".", "H", ".", "H", "H", ".", ".", ".", ":", ".", "H", "H", "H", ".", ".", "H"],
		["H", ".", ".", ".", ".", ".", ".", ".", ".", ".", ".", ".", ".", "H", "H", "H", "H", "H", "H", "H", "H", "H", "H", "H", "H", "H", "H", "H", "H", "H", "H", "H", "H", "H", "H", "H", "H", "H", "H", "H", "H", "H", "H", "H", ".", "H", ".", ".", ".", ".", ".", ":", ".", ".", ".", ".", "H", "\u003E", ".", "H"],
		["H", "\u003E", ".", ".", ".", ".", ".", ".", ".", ".", ".", ".", ".", ".", ".", ".", ".", ".", ".", ".", ".", ".", ".", ".", ".", ".", ".", "P", "\u003E", ".", ".", ".", ".", ".", ".", ".", ".", ".", ".", ".", ".", ".", ".", ".", ".", "H", ".", "H", ".", ".", ".", ".", ".", ".", ".", ".", "H", ".", "?", "H"],
		["H", "H", "H", "H", "H", "H", "H", "H", "H", "H", "H", "H", "H", "H", "H", "H", "H", "H", "H", "H", "H", "H", "H", "H", "H", "H", "H", "H", "H", "H", "H", "H", "H", "H", "H", "H", "H", "H", "H", "H", "H", "H", "H", "H", "H", "H", "H", "H", "H", "H", "H", "H", "H", "H", "H", "H", "H", "H", "H", "H"]
	],
	"BackCover": "/Resources/Media/Images/Locations/FireTemple/Way.svg",
	"BattleBack": "/Resources/Media/Images/Battle/Background/LavaTemple.svg",
	"MusicPeace": "/Resources/Media/OST/Music/FireTemple/Peace.mp3",
	"MusicFight": "/Resources/Media/OST/Music/FireTemple/Fight.mp3",
	"Start": {
		"X": 28,
		"Y": 19
	},
	"Danger": {
		"IsZero": false,
		"X": 15,
		"Y": 60
	},
	"IsTimeChamber": false,
	"StageFoes": [8, 9, 10, 11],
	"Bosses": {
		"28:3": 14
	},
	"Gates": {
		"40:25": {
			"X": 37,
			"Y": 28
		},
		"49:21": {
			"X": 46,
			"Y": 21
		},
		"57:33": {
			"X": 41,
			"Y": 9
		},
		"1:34": {
			"X": 18,
			"Y": 9
		},
		"28:34": {
			"X": 28,
			"Y": 16
		}
	},
	"Warps": {
		"46:18": {
			"X": 28,
			"Y": 1
		},
		"5:15": {
			"X": 28,
			"Y": 19
		}
	},
	"Equipment": {
		"4:17": {
			"Kind": 1,
			"Set": 3
		},
		"23:22": {
			"Kind": 3,
			"Set": 3
		},
		"56:26": {
			"Kind": 0,
			"Set": 3
		},
		"38:28": {
			"Kind": 2,
			"Set": 3
		},
		"46:20": {
			"Kind": 0,
			"Set": 4
		}
	},
	"TileCodes": {
		"\u003C": "/Resources/Media/Images/Locations/Total/Lever/Off.svg",
		"\u003E": "/Resources/Media/Images/Locations/Total/Lever/On.svg",
		"?": "/Resources/Media/Images/Locations/Total/Surprise.svg",
		"H": "/Resources/Media/Images/Locations/FireTemple/Wall.svg",
		"T": "/Resources/Media/Images/Locations/FireTemple/Wall.svg",
		"P": "/Resources/Media/Images/Locations/FireTemple/Wall.svg",
		"X": "/Resources/Media/Images/Locations/FireTemple/Artifact.svg",
		".": "/Resources/Media/Images/Locations/Total/Transparent.svg",
		":": "/Resources/Media/Images/Locations/Total/Spikes.svg",
		"_": "/Resources/Media/Images/Locations/Total/Button.svg",
		"!": "/Resources/Media/Images/Locations/Total/Transparent.svg",
		"I": "/Resources/Media/Images/Locations/Total/Transparent.svg",
		"S": "/Resources/Media/Images/Locations/Total/SafeArea.svg",
		"$": "/Resources/Media/Images/Locations/Total/Chest/Closed.svg",
		"E": "/Resources/Media/Images/Locations/Total/Chest/Opened.svg",
		"K": "/Resources/Media/Images/Locations/Total/Key.svg",
		"#": "/Resources/Media/Images/Locations/Total/Lock.svg",
		"@": "/Resources/Media/Images/Locations/Total/Table.svg"
	}
}
